---------------------------------------------------------
---------------------------------------------------------
.........................................................
....-------+-------......................................
....|.............|......................................
....|.............+......................................
....-------+-------......................................
.........................................................
.........................................................
.........................................................
.........................................................
.........................................................
.........................................................
...............................---+++++----..............
...............................|..........|..............
...............................|..........|..............
...............................|..........+..............
...............................|..........|..............
...............................|..........|..............
...............................+..........|..............
...............................|..........|..............
...............................|..........+..............
...............................+..........|..............
...............................|..........|..............
...............................|..........|..............
...............................----+++-----..............
.....|--+++----+++------|................................
.....|..................|................................
.....+..................+................................
.....|..................+................................
.....|..................|................................
.....+..................|................................
.....--------------------................................
