.........................................................
....---------------......................................
....|.............|......................................
....|.............|......................................
....-------+-------......................................
.........................................................
