............------------                                 
........................|                                
....---.................|                                
....-------++---+--.....|                                
....+.............|.....|                                
....|.............+......|                               
____-------+-------.......|                              
   |...........||||.......|                              
   |...........||.........|                              
   |...........||.........|      ______________          
    |.....................|-----|.............|          
    |.........................................|          
   |...........................................|         
   |....____++_................---+++++----....|         
--|....|.......|------.........|..........|....|         
.......|.......|------.........|..........|.....|        
.......+.......|----...........|..........+.....|        
.......+.......+...............|..........|.....|        
.......|.......+...............|..........|.....|        
.....--|.......|...............+..........|....|         
....---|---+++-|...............|..........|.....|         
......-..............---.......|..........+......|       
.....................| |.......+..........|......|       
---..................|-|.......|..........|......|       
--.............................|..........|......|       
...............................----+++-----......|       
.....|--+++----+++------|........................|       
.....|..................|........................|       
.....+..................+......-------------------       
.....|..................+.......-|                       
.....|..................|.......-|                       
.....+..................|........|                       
_____--------------------________|                       
