4,4,4,4,4,4,4,4,4,4,4,4,4,4,4,4,4,4,4,4,4,4,4,4,4,4,4,4,4,4,4,4,4,4,4,4,4,4,4,4,4,4,4,4,4,4,4,4,4,4,4,4,4,4,4,4,4,4,4,4,4,4,4,4,4
4,0,0,0,0,0,0,0,0,0,0,0,0,0,0,0,0,0,0,0,0,0,0,0,0,0,0,0,0,0,4,0,0,0,0,0,0,0,0,0,0,0,0,0,0,4,7,6,6,6,6,6,7,7,7,1,1,1,1,1,7,7,7,7,4
4,4,4,2,4,4,4,4,2,4,4,4,4,2,4,4,4,4,4,4,4,4,4,4,4,4,4,4,0,0,4,4,0,0,0,0,0,0,0,0,0,0,0,0,4,4,7,6,6,6,6,7,7,7,7,1,0,0,0,1,7,7,7,7,4
4,0,0,0,0,0,4,0,0,0,4,0,0,0,0,0,4,0,0,0,0,0,0,0,0,0,4,0,0,0,0,4,0,0,0,0,0,0,0,0,0,0,0,0,4,7,7,6,6,6,6,7,7,7,7,1,0,0,0,1,7,7,7,7,4
4,0,0,6,0,0,4,0,0,0,4,0,0,6,0,0,4,0,0,0,0,0,0,0,0,0,4,4,0,0,4,4,0,0,0,0,0,0,0,0,0,0,0,0,4,7,6,6,6,6,6,7,7,7,7,1,1,2,1,1,7,7,7,7,4
4,0,6,6,6,0,4,0,0,0,4,0,6,6,6,0,4,0,0,0,0,0,0,0,0,0,4,0,0,0,0,4,0,0,0,0,0,0,0,0,0,0,0,0,4,7,6,6,6,6,7,7,7,7,7,7,7,0,7,7,5,7,7,7,4
4,0,0,6,0,0,4,0,0,0,4,0,0,6,0,0,4,0,0,0,0,0,0,0,0,0,4,4,0,0,4,4,0,0,0,0,0,4,4,4,4,4,0,0,4,6,6,6,6,6,7,7,7,7,7,7,7,0,7,5,5,5,7,7,4
4,0,0,0,0,0,4,0,0,0,4,0,0,0,0,0,4,0,0,0,0,0,0,0,0,0,4,0,0,0,0,4,0,0,0,0,4,4,0,0,0,4,4,0,4,6,6,6,6,7,7,7,5,7,7,7,7,0,7,7,5,7,7,7,4
4,4,4,4,4,4,4,0,0,0,4,4,4,4,4,4,4,0,0,0,0,0,0,0,0,4,4,0,0,0,0,4,4,0,0,0,4,0,0,0,0,0,4,0,4,6,6,6,6,7,7,5,5,5,7,7,7,0,7,7,7,7,7,7,4
4,0,0,0,4,0,0,0,0,0,0,0,4,0,0,0,0,0,0,0,0,0,0,0,4,4,0,0,0,0,0,0,4,4,0,0,4,0,0,0,0,0,4,0,4,6,6,6,6,7,7,7,5,7,7,7,7,0,7,7,7,7,7,7,4
4,0,0,0,4,0,0,0,0,0,0,0,4,0,0,0,0,0,0,4,4,4,4,4,4,0,0,0,0,0,0,0,0,4,4,0,4,4,0,0,0,4,4,0,4,6,6,6,6,7,7,7,7,7,7,7,7,0,7,7,7,7,7,7,4
4,0,0,0,4,0,0,0,0,0,0,0,4,0,0,0,0,0,4,4,0,0,4,4,0,0,0,4,4,4,4,0,0,0,4,4,4,4,4,2,4,4,4,4,4,4,4,1,1,1,7,7,7,7,7,7,7,0,7,7,1,1,1,1,4
4,0,0,0,4,0,0,0,0,0,0,0,4,0,0,0,0,4,4,0,0,0,4,0,0,0,0,4,0,0,4,0,0,0,0,0,0,0,0,0,0,0,0,0,0,0,4,0,0,7,7,7,7,7,7,7,7,0,7,7,1,0,0,1,4
4,0,0,0,4,0,0,0,0,0,0,0,4,0,0,0,0,4,0,0,0,0,2,0,0,0,0,2,0,0,2,0,0,0,0,0,0,0,0,0,0,0,0,0,0,0,2,0,0,0,0,0,0,0,0,0,0,0,0,0,2,0,0,1,4
4,0,0,0,4,0,0,0,0,0,0,0,4,0,0,0,0,4,4,0,0,0,4,0,0,0,0,4,0,0,4,0,0,0,0,0,0,0,0,0,0,0,0,0,0,0,4,0,0,7,7,7,7,0,7,7,7,7,7,7,1,0,0,1,4
4,0,0,0,4,0,0,0,0,0,0,0,4,0,0,0,0,0,4,4,0,0,4,4,0,0,0,4,4,4,4,0,0,0,4,4,4,4,4,2,4,4,4,4,4,4,4,1,1,1,7,7,7,0,7,7,7,5,7,7,1,1,1,1,4
4,0,0,0,4,1,1,1,0,1,1,1,4,0,0,0,0,0,0,4,4,4,4,4,4,0,0,0,0,0,0,0,0,4,4,0,4,4,0,0,0,4,4,0,4,4,6,6,6,7,7,1,1,2,1,1,5,5,5,7,7,7,7,7,4
4,0,0,0,4,1,6,1,0,1,6,1,4,0,0,0,0,0,0,0,0,0,0,0,4,4,0,0,0,0,0,0,4,4,0,0,4,0,0,0,0,0,4,4,4,6,6,6,6,7,7,1,0,0,0,1,7,5,7,7,7,5,7,7,4
4,0,0,0,4,1,1,1,1,1,1,1,4,0,0,0,0,0,0,0,0,0,0,0,0,4,4,0,0,0,0,4,4,0,0,0,4,0,0,0,0,0,4,4,6,6,6,6,6,6,7,1,0,0,0,1,7,7,7,7,5,5,5,7,4
4,0,0,0,4,4,4,4,4,4,4,4,4,0,0,0,0,0,0,0,0,0,0,0,0,0,4,0,0,0,0,4,0,0,0,0,4,4,0,0,0,4,4,4,6,6,6,6,6,6,7,1,1,1,1,1,7,7,7,7,7,5,7,7,4
4,4,4,4,4,4,4,4,4,4,4,4,4,4,4,4,4,4,4,4,4,4,4,4,4,4,4,9,9,9,9,4,4,4,4,4,4,4,4,4,4,4,4,4,4,4,4,4,4,4,4,4,4,4,4,4,4,4,4,4,4,4,4,4,4