1,1,1,1,1,1,1,1,1,1,1,1,1,1,1,1,1,1,1,1,1,1,1,1,1,1,1,9,9,9,9,1,1,1,1,1,1,1,1,1,1,1,1,1,1,1,1,1,1,1,1,1,1,1,1,1,1,1,1,1,1,1,1,1,1
1,4,4,4,4,4,4,4,5,5,5,5,5,5,5,5,5,5,5,1,1,1,5,5,5,5,4,0,0,0,0,4,5,5,5,5,5,5,5,5,5,5,5,5,5,5,5,5,5,5,5,5,5,5,5,5,5,5,5,5,5,5,5,5,1
1,4,6,4,0,4,6,4,5,5,5,5,5,5,5,5,5,5,5,1,9,1,5,5,5,5,4,0,0,0,0,4,5,5,5,5,5,5,5,5,5,5,5,5,5,5,5,5,5,5,5,5,5,5,5,5,5,5,5,5,5,5,5,5,1
1,4,4,4,0,4,4,4,5,5,5,5,5,5,5,5,5,5,5,5,7,7,5,5,5,5,4,4,2,0,4,4,5,5,5,5,5,5,5,5,5,5,5,5,5,5,5,5,5,5,5,5,5,5,5,5,5,5,1,1,1,5,5,5,1
1,5,0,0,0,0,0,5,5,5,5,5,5,5,5,5,5,5,5,5,5,7,7,7,7,7,7,0,7,0,7,0,7,7,5,5,5,5,5,5,5,5,5,5,5,5,5,5,5,5,5,5,5,5,5,5,5,1,1,0,0,1,5,5,1
1,5,5,0,0,0,5,5,5,5,5,5,5,5,5,5,5,5,6,5,5,5,5,5,5,5,5,5,0,0,0,7,7,7,5,5,5,5,5,5,5,5,5,5,5,5,5,5,5,5,5,7,7,7,7,7,7,2,0,0,0,0,1,5,1
1,5,5,5,0,5,5,5,5,5,5,5,5,5,5,5,5,6,6,6,5,5,6,6,5,5,5,5,5,5,5,5,7,0,5,5,5,5,5,5,5,5,5,5,5,5,5,5,5,5,5,7,5,5,5,5,5,1,1,0,0,1,5,5,1
1,5,5,5,0,5,5,5,5,5,5,5,5,5,5,5,5,6,6,6,6,6,6,6,6,6,6,6,5,5,5,1,0,7,5,5,5,5,5,5,5,5,5,5,5,5,5,5,5,5,7,7,5,5,7,7,5,5,1,1,1,1,5,5,1
1,5,5,6,0,6,5,5,5,5,7,5,5,5,5,5,5,6,6,6,6,6,6,6,6,5,6,6,6,5,5,1,0,0,1,5,5,5,6,5,5,6,5,5,5,5,5,5,5,5,7,7,7,5,7,7,5,5,5,1,9,1,5,5,1
1,5,5,5,0,5,5,5,5,7,7,8,5,7,5,5,5,5,6,6,6,6,6,6,5,9,7,6,6,6,6,1,0,0,1,5,5,6,6,5,6,6,5,5,5,5,5,5,5,5,5,7,7,7,5,5,5,7,7,7,7,5,5,5,1
1,5,5,6,0,6,5,5,5,8,7,7,7,8,7,7,5,5,5,6,6,6,6,6,9,5,7,7,6,6,6,6,6,0,1,6,6,6,6,6,6,6,5,5,5,5,5,5,5,5,5,5,7,7,5,5,5,7,5,7,5,5,5,5,1
1,5,5,5,0,5,5,5,5,7,7,5,7,5,5,7,5,5,5,6,6,6,6,6,7,8,7,6,6,6,6,1,6,0,1,6,6,6,6,6,5,5,5,5,5,5,5,5,5,5,5,5,5,7,5,5,5,7,5,5,5,5,5,5,1
1,5,5,1,0,1,5,5,5,7,5,7,8,5,7,7,5,5,5,5,6,6,6,6,6,7,6,6,6,6,6,1,0,0,1,6,6,6,6,6,6,5,5,5,5,5,5,5,5,5,5,5,5,7,5,5,7,7,7,7,7,7,7,7,9
1,5,5,1,9,1,5,5,7,7,7,8,7,7,7,7,5,5,5,5,5,6,6,6,6,6,6,5,5,5,5,1,0,6,6,6,6,6,6,6,6,5,5,5,5,5,5,5,5,5,5,5,5,7,5,5,7,7,5,7,5,7,7,7,9
1,5,5,1,1,1,5,5,7,7,5,5,7,7,8,5,5,5,5,5,5,5,5,6,6,6,6,5,5,5,5,5,0,0,1,5,6,6,5,6,6,6,5,5,5,5,5,5,5,5,5,5,5,7,5,5,5,7,7,7,5,7,7,7,9
1,5,5,5,5,5,5,5,7,7,7,7,7,7,1,5,5,5,5,5,5,5,5,5,5,5,5,5,5,5,5,5,0,0,5,5,5,5,5,5,6,5,5,5,5,5,5,5,5,5,5,5,7,7,7,5,5,5,7,5,5,7,7,7,9
1,5,5,5,5,5,5,5,5,5,1,1,1,7,1,5,5,5,7,7,7,5,5,5,5,7,7,7,7,0,0,0,0,0,5,5,5,5,5,5,5,5,5,5,5,5,5,5,5,5,5,7,7,7,7,7,5,5,5,5,5,7,7,5,1
1,5,5,5,5,5,5,5,5,5,5,5,5,7,7,7,7,7,7,5,7,7,7,7,7,7,7,5,5,5,5,5,0,0,0,5,5,5,5,5,5,5,5,5,5,5,5,5,5,5,5,7,8,7,7,7,7,7,7,7,7,7,7,5,1
1,5,5,5,5,5,5,5,5,5,5,5,5,5,5,5,5,5,5,5,5,5,5,5,5,5,5,5,5,5,5,5,5,5,0,0,0,7,0,0,7,0,7,7,0,7,7,7,7,7,7,7,7,7,8,7,7,7,7,7,7,7,7,5,1
1,5,5,5,5,5,5,5,5,5,5,5,5,5,5,5,5,5,5,5,5,5,5,5,5,5,5,5,5,5,5,5,5,5,5,5,5,5,5,5,5,5,5,5,5,5,5,5,5,5,5,5,7,7,7,5,5,5,5,5,5,5,5,5,1
1,1,1,1,1,1,1,1,1,1,1,1,1,1,1,1,1,1,1,1,1,1,1,1,1,1,1,1,1,1,1,1,1,1,1,1,1,1,1,1,1,1,1,1,1,1,1,1,1,1,1,1,1,1,1,1,1,1,1,1,1,1,1,1,1