1,1,1,1,1,1,1,1,1,1,1,1,1,1,1,1,1,1,1,1,1,1,1,1,1,1,1,1,1,1,1,1,1,1,1,1,1,1,1,1,1,1,1,1,1,1,1,1,1,1,1,1,1,1,1,1,1,1,1,1,1,1,1,1,1
1,7,7,7,7,7,7,7,7,7,7,7,7,7,7,7,7,7,7,1,1,1,7,7,7,7,7,7,7,7,7,7,7,7,7,7,7,1,1,1,1,1,7,7,7,7,7,7,7,7,7,7,7,7,7,7,7,7,7,7,7,7,7,7,1
1,7,1,1,1,1,1,7,7,7,7,7,7,7,7,1,1,1,1,1,9,1,7,7,7,7,7,1,1,1,1,1,7,7,7,7,1,1,0,0,0,1,1,7,7,7,7,7,7,7,7,7,7,7,7,7,7,7,7,7,7,7,7,7,1
1,7,1,0,0,0,1,7,7,7,7,7,7,7,7,1,0,0,1,1,0,1,1,1,1,1,1,1,0,0,0,1,1,1,1,1,1,0,0,1,0,0,1,1,7,7,7,7,7,7,7,7,7,7,7,7,7,7,7,7,7,7,7,7,1
1,7,1,0,1,0,1,1,1,1,1,1,1,1,7,1,0,0,2,0,0,0,0,0,0,0,0,0,0,6,0,0,0,0,1,1,0,0,1,1,1,0,0,1,1,1,1,1,1,1,1,1,1,1,1,1,1,1,1,1,7,7,7,7,1
1,7,1,0,1,0,0,0,0,0,0,0,6,1,1,1,0,0,1,1,1,1,1,1,1,1,1,1,0,0,0,1,1,0,1,0,0,1,1,1,1,1,0,0,0,0,0,0,0,0,0,0,0,0,0,0,0,0,0,1,7,7,7,7,1
1,7,1,0,1,1,1,1,1,6,0,6,0,0,1,1,1,1,1,7,7,7,7,7,7,7,7,1,1,1,1,1,1,0,0,0,1,1,1,0,1,1,1,1,1,1,2,1,1,1,1,1,1,1,1,1,1,1,0,1,7,7,7,7,1
1,7,1,0,0,1,1,1,6,6,0,0,6,0,0,1,7,7,7,7,7,7,7,7,7,7,7,7,7,7,7,7,1,1,1,0,1,1,0,0,0,1,1,7,7,1,0,1,7,7,7,7,7,7,7,7,7,1,0,1,1,1,7,7,1
1,7,1,4,0,4,1,1,0,6,6,0,0,0,6,1,7,7,7,7,7,7,7,7,1,1,1,1,1,1,7,7,7,7,1,0,0,2,0,0,0,0,1,7,1,1,0,1,1,7,7,7,7,7,7,7,7,1,0,1,9,1,7,7,1
1,7,1,6,0,6,1,1,0,0,0,0,6,6,0,1,7,7,7,7,7,7,7,1,1,9,0,0,0,1,7,7,7,7,1,1,1,1,0,0,0,1,1,7,1,0,0,0,1,7,7,7,1,1,1,1,1,1,0,0,0,1,7,7,1
1,7,1,4,0,4,1,1,0,6,6,6,0,0,0,1,7,7,7,7,7,7,7,1,9,1,1,1,0,1,1,7,7,7,7,7,7,1,1,0,1,1,7,7,1,1,0,1,1,7,7,7,1,0,0,0,1,1,1,1,0,1,7,7,1
1,7,1,6,0,6,1,1,0,0,0,0,0,6,0,1,7,7,7,7,7,7,7,1,0,1,1,0,0,6,1,1,1,7,7,7,7,7,1,1,1,7,7,7,7,1,1,1,7,7,7,7,1,0,0,0,1,7,7,1,0,1,7,7,1
1,7,1,4,0,4,1,1,6,6,6,6,6,0,0,1,7,7,7,7,7,1,1,0,0,1,0,0,6,6,6,6,1,7,1,1,1,1,1,7,7,7,7,1,1,1,7,7,7,7,7,7,1,0,0,0,1,7,7,1,0,1,7,7,1
1,7,1,1,9,1,1,1,0,6,0,0,0,0,6,1,7,7,7,7,1,1,0,0,1,1,0,6,6,6,0,1,1,7,1,0,0,0,1,7,7,7,1,1,0,1,1,7,7,7,7,7,1,1,2,1,1,7,7,1,0,1,7,7,1
1,7,7,1,1,1,7,1,1,0,0,6,6,6,1,1,7,7,7,1,1,0,0,1,1,1,0,0,6,0,0,1,7,7,1,0,1,0,1,1,1,1,1,0,0,0,1,1,1,1,7,7,7,1,0,1,1,1,7,1,0,1,7,7,1
1,7,7,7,7,7,7,7,1,1,0,0,6,1,1,7,7,7,1,1,0,0,1,1,7,1,1,0,0,0,1,1,7,7,1,0,1,0,0,0,0,0,0,0,0,0,0,0,0,1,7,7,7,1,0,0,0,1,1,1,0,1,7,7,1
1,7,7,7,7,7,7,7,7,1,1,0,1,1,1,1,1,1,1,0,0,1,1,7,7,7,1,1,0,1,1,1,1,1,1,0,1,1,1,1,1,1,1,0,0,0,1,1,0,1,7,7,7,1,1,1,0,0,0,0,0,1,7,7,1
1,7,7,7,7,7,7,7,7,7,1,0,1,1,0,0,0,0,0,0,1,1,7,7,7,7,7,1,0,0,0,0,0,0,0,0,1,7,7,7,7,7,1,1,0,1,1,1,0,1,1,1,1,1,1,0,0,1,1,1,1,1,7,7,1
1,7,7,7,7,7,7,7,7,7,1,0,0,0,0,1,1,1,1,1,1,7,7,7,7,7,7,1,1,1,1,1,1,1,1,1,1,7,7,7,7,7,7,1,1,1,7,1,0,0,0,0,0,0,0,0,1,1,7,7,7,7,7,7,1
1,7,7,7,7,7,7,7,7,7,1,1,1,1,1,1,7,7,7,7,7,7,7,7,7,7,7,7,7,7,7,7,7,7,7,7,7,7,7,7,7,7,7,7,7,7,7,1,1,1,1,1,1,1,1,1,1,7,7,7,7,7,7,7,1
1,1,1,1,1,1,1,1,1,1,1,1,1,1,1,1,1,1,1,1,1,1,1,1,1,1,1,1,1,1,1,1,1,1,1,1,1,1,1,1,1,1,1,1,1,1,1,1,1,1,1,1,1,1,1,1,1,1,1,1,1,1,1,1,1