1,1,1,1,1,1,9,9,9,9,9,9,1,1,1,1,1,1,1,1,1,1,1,1,1,1,1,1,1,1,1,1,1,1,1,1,1,1,1,1,1,1,1,1,1,1,1,1,1,1,1,1,1,1,1,1,1,1,1,1,1,1,1,1,1
1,5,5,5,5,5,7,7,7,7,7,7,5,5,5,5,5,7,7,7,7,7,7,7,7,7,7,7,7,7,6,6,6,6,7,7,7,7,7,7,7,7,7,7,7,7,7,7,7,7,7,7,7,7,7,7,7,7,7,5,5,5,5,5,1
1,5,5,5,5,5,7,7,7,7,7,7,5,5,5,5,7,7,7,7,7,7,7,7,5,5,7,7,7,7,6,6,6,6,7,7,7,8,7,7,7,7,7,7,7,8,7,7,7,7,1,1,1,1,1,7,7,7,7,7,5,5,5,5,1
1,5,5,5,5,5,7,7,7,7,7,7,5,5,5,5,5,5,5,7,7,7,5,7,5,5,7,7,7,6,6,6,6,7,7,7,7,7,5,7,7,8,7,7,7,7,7,7,7,7,1,0,0,0,1,7,7,7,8,7,7,7,5,5,1
1,5,5,5,5,7,7,7,7,7,7,7,7,5,5,5,5,5,7,7,7,7,5,5,5,7,7,6,6,6,6,7,7,7,8,7,7,7,7,7,7,8,7,7,7,7,7,7,7,7,1,0,0,0,1,8,7,7,7,7,7,5,5,5,1
1,5,5,5,7,7,7,7,7,7,7,7,7,7,5,5,5,7,7,7,7,7,7,7,7,7,7,6,6,6,6,7,7,7,7,7,7,8,7,5,7,7,7,7,7,7,8,7,7,7,1,1,2,1,1,7,7,7,7,5,7,8,7,5,1
1,5,5,7,7,7,7,7,7,7,5,7,7,7,7,5,7,7,7,7,5,7,7,7,7,7,7,6,6,6,6,7,7,8,7,7,7,7,5,6,5,7,7,8,7,5,5,7,7,7,7,7,7,8,7,7,7,8,7,7,7,7,7,7,1
1,5,5,7,7,7,5,7,7,7,5,5,5,7,7,7,7,7,7,5,5,7,7,7,7,1,1,1,1,1,1,7,7,7,7,7,7,7,7,5,5,7,7,7,7,7,5,7,8,7,7,7,7,7,7,7,7,7,7,7,7,7,7,7,1
1,5,5,7,7,5,5,7,7,7,5,5,7,5,7,7,7,7,5,5,7,7,7,7,7,0,0,0,0,0,0,7,7,7,5,7,7,7,8,7,7,7,7,7,5,7,7,7,7,7,7,7,7,7,7,8,7,5,7,7,7,7,7,7,1
1,5,5,7,7,5,5,7,7,7,7,7,7,7,7,7,7,7,7,7,7,7,7,7,7,0,0,0,0,0,0,7,7,7,5,7,7,7,7,7,7,7,5,7,7,7,7,8,7,7,7,8,7,5,7,7,7,5,5,5,7,7,5,7,1
1,5,5,7,7,7,5,7,5,7,5,5,7,7,7,7,7,7,7,7,7,7,7,7,7,1,1,1,1,1,1,7,7,7,7,7,7,7,7,7,7,7,5,7,5,7,7,7,7,7,7,7,5,5,7,7,7,7,5,5,7,7,5,5,1
1,5,5,7,7,7,5,7,5,5,5,5,7,7,7,5,5,7,7,5,7,7,7,7,7,6,6,6,6,7,7,7,7,7,7,8,7,7,7,7,7,7,7,7,7,7,7,7,7,8,7,7,7,5,7,7,7,7,7,5,7,7,7,7,1
9,7,7,7,7,7,7,7,7,5,7,7,7,7,7,5,5,5,5,5,7,7,7,7,6,6,6,6,7,7,7,7,7,7,7,7,7,7,7,7,8,5,5,7,7,7,5,7,7,7,7,7,7,7,7,8,7,7,7,7,7,7,7,7,1
9,7,7,7,7,7,7,7,7,7,7,7,7,7,7,7,7,7,7,7,7,7,7,6,6,6,6,7,7,7,7,8,7,7,7,7,7,5,7,7,7,5,5,8,7,7,7,5,7,7,7,7,7,7,7,7,7,7,7,7,8,5,7,7,1
9,7,7,7,7,7,7,7,7,7,7,7,7,6,6,7,7,7,7,7,7,7,7,6,6,6,6,7,7,7,7,7,7,7,8,7,5,5,7,7,7,7,5,7,7,7,7,7,7,7,8,7,7,7,7,7,7,7,7,7,7,5,5,5,1
9,7,7,7,7,7,5,5,5,5,6,6,6,6,6,6,6,6,7,7,7,7,7,6,6,6,6,7,7,8,7,7,5,5,7,7,7,8,7,7,7,7,5,7,7,7,7,7,7,7,7,7,7,7,7,7,5,7,7,7,5,5,7,5,1
1,5,5,7,7,7,5,5,6,6,6,6,6,6,6,6,6,6,6,6,7,7,6,6,6,6,6,7,7,7,7,7,5,5,5,7,7,7,7,7,7,7,7,7,7,7,7,7,8,7,7,7,7,7,8,5,5,5,7,8,7,7,5,7,1
1,5,5,5,5,5,5,6,6,6,6,6,6,6,6,6,6,6,6,6,6,6,6,6,6,6,7,7,7,7,8,7,7,5,7,7,7,7,7,7,7,7,7,8,7,7,7,7,7,5,7,7,7,7,7,7,5,7,7,7,7,7,7,7,1
1,5,5,5,5,5,7,6,6,6,6,6,6,6,6,6,6,6,6,6,6,6,6,6,6,7,7,7,8,7,7,7,7,7,7,8,7,7,7,7,7,7,7,7,7,7,5,5,7,7,7,8,7,7,7,7,7,7,7,5,7,7,7,7,1
1,5,5,5,5,5,6,6,6,6,6,6,6,6,6,6,6,6,6,6,6,6,6,6,7,7,7,7,7,7,7,7,7,8,7,7,7,7,7,7,7,7,7,7,7,8,5,5,5,7,7,7,7,7,7,7,7,8,7,5,7,7,7,7,1
1,1,1,1,1,1,1,1,1,1,1,1,1,1,1,1,1,1,1,1,1,1,1,1,1,1,1,1,1,1,1,1,1,1,1,1,1,1,1,1,1,1,1,1,1,1,1,1,1,1,1,1,1,1,1,1,1,1,1,1,1,1,1,1,1